......OOO......
.....OOOOO.....
....OOOOOOO....
....OOOOOOO....
....OOOOOOO....
...OOOOROOOO...
...OOORRROOO...
...OOOOROOOO...
...OOOROROOO...
...OOOOOOOOO...
....OOOOOOO....
....OOOOOOO....
....OOOOOOO....
.....OOOOO.....
......OOO......
