....G........X.
...GGG......XXX
...GGG.......X.
....G..BBB.....
......BBBBB....
.....BBBBBBB...
.....BBWWWBB...
.....BBWBWBB...
.....BBWWWBB...
.....BBWBBBB...
.....BBWBBBB...
.....BBWBBBB...
.X....BBBBB....
XXX....BBB.....
.X.............
