B..............
BA.............
BAG............
BAGY...........
BAGYO..........
BAGYOR.........
BAGYORW........
BAGYORWP.......
BAGYORWPB......
BAGYORWPBA.....
BAGYORWPBAG....
BAGYORWPBAGY...
BAGYORWPBAGYO..
BAGYORWPBAGYOR.
SSSSSSSSSSSSSSW
