...............
...............
.XYXYXYXYXYXYX.
.XYXYXYXYXYXO..
.XYXYXYXYXYO...
.XDXDXDXDXO....
.XDXDXDXYO.....
.XDXDXYXO...A..
.XDXYXYO....B..
.XYXYXO.....W..
.XYXYO......W..
.XYXO.......W..
.XYO........W..
.XO............
.O.............
