...............
...............
....G.....G....
.....GR.RG.....
....GGGGGGG....
...GG.GGG.GG...
..GGGGGGGGGGG..
..G.GGGGGGG.G..
..G.G.....G.G..
.....GG.GG.....
...............
...............
S.S.S.S.S.S.S.S
...............
...............
