...............
.SSSSSS.SSSSSS.
.S...........S.
.S.DDDD.DDDD.S.
.S.D.RPRPR.D.S.
.S...PRPRP...S.
.S.D.RPRPR.D.S.
.S.DDDD.DDDD.S.
.S...........S.
.SSSSSS.SSSSSS.
...............
...............
X.....X.X.....X
...............
...............
