...............
.P..P.P..P.P..P
..YY...YY...YY.
..GG...GG...GG.
.A..A.A..A.A..A
D....D....D....
.W..W.W..W.W..W
..RR...RR...RR.
..PP...PP...PP.
.Y..Y.Y..Y.Y..Y
D....D....D....
.A..A.A..A.A..A
..BB...BB...BB.
...............
...............
