...............
.......O.......
..O....O....O..
...O...O...O...
....O..O..O....
.....O.O.O.....
......OOO......
.OOOOOOOOOOOOO.
......OOO......
.....O.O.O.....
....O..O..O....
...O...O...O...
..O....O....O..
.......O.......
...............
