...............
B.B.B.B.B.B.B.B
...............
.SSSS.S..S.SSS.
.S....SS.S.S..S
.S....SS.S.S..S
.SSS..S.SS.S..S
.S....S.SS.S..S
.S....S..S.S..S
.SSSS.S..S.SSS.
...............
D..D..D..D..D.D
...............
X..X..X..X..X.X
...............
